   WWW
   WEW
   W.W
   W.WWWWWWW
   W...o...W
WWWWWWWWWW.W
W.......o..W
W.WWWWWWWWWW
W..o......HW
WWWWWWWWWWWW