   WWW
   WEW
   W.W
   W.WWWWWWW
   W3..o..2W
WWWWWWWWWW.W
W1......o.4W
W.WWWWWWWWWW
W3.o......HW
WWWWWWWWWWWW